3131143113213213413121321313112222221213
1000000000000000000000000000000000000001
3004000000000000000000000000000000000003
2000004004444000004000000000400444433333
4000000000000000000000000000000000000301
4000000000000000000000000000000000000303
3000000000000000000000000000000000000301
4000000000000000020000000010000000000303
3000000000000000000000000000000000000301
1000002223313333344444444000000000000304
3000000000000000100000000000100000000402
1000000000010000000000000000000000000404
3000000001000000000100000000000000000401
2000000000000100000000000P00000000000404
3000000000000000010000000000000100000401
1000000033330333333330000000000000000401
4000000003000000000010000000000000000404
2000000003000004444444440000000000000401
3000000003000000000000100000000000000401
1000000003000000000000000004444440400004
3000000000000000000000000000000000000001
2000000000000000000000000000000000000001
3000001000010010100000200100000000000004
4000000000000000000000100000000000000001
3000000000000000000001000000000000000002
1000000000000000000000000000000000000004
1000000000000000000000000000000000000002
2000101010102112000220201000000000000002
1000000000000000000000000000000000000004
3000000100000100001010000020000000000001
2000000000000000000000000000000000000001
1000000300010101030214200012010100000004
1000000000000000000000000000000000000004
1000000000000000000000000000000000000004
4000000030000000000000000000000000000004
2000000000000000000300000000000000000004
2000000000000000300000000000000000000001
4000000000000000030300000000000000000004
1000000000000000000000000000000000000001
1132231121343123212313333331133211313114
